반차 => 오전반차/오후반차
사수/부사수 => 직속 선임자, 사수랑 상관은 다름. 업무를 알려주느냐 안알려주느냐 하는차이
세금계산서 => 거래 사실을 통해서 부가세 징수하려고 발급하는 영수증, 신용카드 전표
연차 => 일년동안 80퍼이상 출근하면 연차가 발생. 약 15일의 유급휴가
asap => as soon as possible 가능한 빨리
FW => 메일, 전달
N/A => not applicable 해당없음 이용불가
Re => 메일, 회신
T.F.T => 회사의 특수한 멤버로 새로운 팀이 꾸려지는 것(Task force team. tf팀. 회사의 일상 업무가 아닌 특별한 프로젝트를 수행할때)
품의서 => 품의: 이거 해도 되냐고 물어보는 것. 진행하기 앞서서 허락 또는 승인을 구함. 
기안서 => 품의 이후 상세한 계획을 결재를 올리는 것이 기안서
결재 => 결정을 허가 받는 것.
C.C => carbon copy. 업무와 연관된 사람을 참조에 넣어 내용 공유
XPI => key performance indicators 목표 달성을 위한 관리해야할 요소에 대한 성과지표
반려 => 하지마세요 라는 뜻, 재 기안을 올리면 됌.


킥오프 => 개발의 시작. 업무내용, 진행방향 등을 논의하는 미팅
검수 => 구글 스토어, 애플 앱스토어의 검수
정기점검 => 서비스를 잠시 멈추고 데이터백업, 업데이트를 진행하는 점검. 보통 주중에함
라이트유저 => 서비스를 부담없이 즐기는 유저
해비유저=> 서비스를 많이 즐기는 유저, 과금러, 핵 과금러
하드코어유저 => 서비스를 많이 즐기는 유저인데 엄청 많이 즐김. 헤비유저와 비슷.
매크로=> 조작 순서를 기록해서 자동으로 실행하는 것.
모드=> 하나의 방식이나 상태를 말함
마일스톤=> 이정표 돌. 프로젝트 상의 중요한 시점을 또는 목표의 완료 일정에 관한 계획
백서버 =>  일부 또는 전체 고객에게 정보를 특정 시간대로 되돌리거나 일정 시간 서비스가 저장이 안되는 현상
부분 유료화 => 이용은 무료, 일부 필요한 기능을 판매하는 방식. Freemiun. Free to play
바이럴 마케팅 => 소비자들이 자발적으로 메시지 전달해서 입소문을 내게하는 마케팅 기법
서버통합 => 두개 이상의 서버를 통합하여 하나의 서버로 만드는 과정
유저시나리오 => 유저가 경험하게 되는 서비스의 흐름
스킬 => 게임에서 사용하는 특수한 행동, 기술
리스폰 => 생성, 재생성
알파테스트 => 지속 개발할 지 판단하는 시연용 개발 버전
어그로 => 화가 나도록 하거나, 공격적인 방법으로 주목을 받을 때
어뷰징 => 비정상적인 방법으로 서비스의 약점을 이용하여 이득을 보는 행위
영구정지 => 서비스 이용 규제에 따라서 서비스 접근을 막는법
운영 정책 => 이용 및 운영에 필요한 정책
인스턴스 던전 => 플레이어의 그룹만 공유하는 던전, 던전 정보를 복사하여 생성
앱스토어 => ios 에서 응용프로그램을 구입할 수 있는 플랫폼
오픈마켓 => 자유로운 거래를 하게 만든 시장
임시점검 => 이슈 발생시 즉각 대처가 필요할 때
핫픽스 => 약점 보완, 또는 성능 향상을 위해 긴급히 배포되는 패치 프로그램
잠수함 패치 => 유저 몰래 수정 사항을 반영하는 것
존 로딩 방식 => 인스턴스형으로 던전을 쪼개서 패킷이 과하게 늘어나지 않게 하는 장치.  => 세네명이 던전을 참여함으로써 액션성을 뛰어나게 할 수 있음, 만약에 공선전에서 점프를 하면 공성전에 참여한
몇백명에게 점프했다는 데이터를 전달 해야함. '지역을 분할하고 지역을 진입할 때 로딩을 진행함. 플레이의 단절 발생'
심 리스 방식 => like 와우. 대규모월드. 해당 위치에 있을때 그그 근처에 있는 사람만 프리로딩. 멀리있으면 반쯤 로딩. 그리고 그쪽으로 가면 또 로딩. 그러므로 이동 속도가 느려야 한다. 스핵같은걸쓰면 아무거도 없는 곳에 도착할 수도있음
게임이 끊김이 없음. like 오픈월드게임 ' 유저들이 현 포지션에서 취할 수 있는 포지션을 예측하여 미리 로딩하는 방식'
정액제 => 매월, 매년, 매주 분기마다 정확한 금액을 내고 이용하는 과금 방식 (구독제)
종량제 => 사용한 양만큼 금액을 내고 이용하는 과금방식 (like 와우 30시간 )
채널링 => 서비스를 a를 통해서도 할수 있고 b에서도 할 수 있다. (ex. 스팀에 있는게임을 엑박 등 여러마켓에서 즐길 수 있다.) '한개의 서비스를 2개이상의 사업자를 통해 퍼블리싱 하는 것'
퍼블리싱 => 없던 서비스를 출시 하는 것. '서비스 사업자를 통해 서비스를 시작하는 것'
퀘스트 => 미션. 게임등에서 유저에게 임무를 부여하고 수행하면 보상을 주는 시스템
텀시트(term sheet) => 계약 사항에 따른 내용을 문서화 해여서 양사가 확인하는 절차.
패치 => 오류나 데이터를 수정하는 행위
프로토타입 => 형상 도는 설계 , 적합성 등을 평가하기 위하여 미리 만들어서 확인하기 위한 모형
페이지 좋아요 => 광고를 시청후 24시간 내에 좋아요가 발생했는지
페이지 참여 => 광고를 시청하고 24시간 내에 좋아요 댓글, 공유, 쿠폰, 팔로우, 조회 , 체크인, 게시물 링크 등등
핵앤슬래쉬 => 단순한 방식으로 몬스터를 몰고 다니면서 때리고 사냥하는 재미를 느끼도록 만든 게임 방식 like 디아블로
횡스크롤 =>  화면이 가로 방향으로 진행하면서 레벨을 옮기는 스타일의 게임
활동 => 광고를 시청하고 24시간, 클릭한지 28일 이내에 앱설치, 좋아요, 댓글,체크인,게시물 링크 등등
ARM => Acquisition Retention Monetzation 유입, 잔존, 매출
API => 프로그램 또는 애플리케이션운영에서 특정한 처리를 위하여 호출할 수있는 서브루틴 또는 함수
CBT => closed beta test 제약된 사용자를 대상으로 테스트
CID => 채널 ID 유저가 서비스에 접속했을 때 발생하는 데이터 베이스 ID 값
DI =>duplication information 중복확인
DOT => Damage over time 대상에게 지속적으로 들어가는 데미지
DPS => Damage Per seconds 초당 입히는 데미지량
FGT => Focus group test  이 물건을 쓸거같은사람들을 가지고 테스트함 (화장품 테스트는 화장품 잘쓰는 사람한테) <-----> UFGT unfocus group test 이거 진짜 안쓸것 같은 사람들을 대상으로 테스트
Gantt 차트 => 목적과 시간 두 기본 요소를 이용해 스케쥴을 정리
GM => Game Master 게임아나 서비스를 진행하는 운영 담당자
IGA => In game Ad 인게임광고
IP => Intellectual Property . 지적 재산권. 유명 타이틀, 콘텐츠에 대한 지적 재산권( 재산권, 권역별 라이센스 등)
IAP => In app Purchase 앱내 결제. 앱을 결제하는 것이아니라 앱 내의 추가기능 활성화 등을 위해 결제하는것
MIM => Mobile instance Messanger  => 모바일에서 IM 을 하는 것. 모바일 메신저 서비스
IM => Instance Messanger => 싸이월드, 버디버디
MOU => 양해 각서. 본격적으로 거래하기 전에 당사자간 협의하는 협약 문서
Niche Market => 틈새시장. 매우 작은 마켓
NPC => None Player Character 플레이하지 않는 캐릭터. 유저가 조종하지 않는 인물. 상점주인, 대장장이, 몬스터.
NDA => 기밀유지 협약. 양사간의 사업비밀을 공유하는데 정보 공개와 사용을 제한하기 위해 체결
OBT=>  Open Beta Test 공개 테스트
PG사 => 카카오 페이, 모바일 뱅킹등. 결제를 대행해주는 회사
Pve => Player vesus enemy . envirom ment 플레이어를 제외한 플레이어 대 환경의싸움
Pvp => Player versus Player 정해진 룰에 따라 플레이어간 전투 하는 행위
QA => Quality Assurance . 서비스의 테스트, 분석을 통하여 문제를 파악하고 퀄리티를 올리는 품질관리 활동 .(6시그마)
R/S => Revenue Share 수익을 배분하는 것
RPG =>  Role Playing Game
RTS => Real Time Strategy Simulation . 실시간 전략 게임
SNG => 소셜 네트워크 게임
SNS => 소셜 네트워크 서비스
VOC => Voice of Customer . 고객의 소리
Ux 테스트 => User Experience test 사용자 경험을 테스트 해보는 것.









